{
  "name": "Госпиталь",
  "width": 18,
  "height": 14,
  "player_start": [5, 5],
  "tiles": [
    [0,0,0,0,0,0,0,0,0,0,0,0,0,0,0,0,0,0],
    [0,1,1,1,1,1,0,1,1,1,1,1,0,1,1,1,1,0],
    [0,1,1,1,1,1,0,1,1,1,1,1,0,1,1,1,1,0],
    [0,1,1,1,1,1,0,1,1,1,1,1,0,1,1,1,1,0],
    [0,1,1,1,1,1,0,1,1,1,1,1,0,1,1,1,1,0],
    [0,1,1,1,1,1,5,1,1,1,1,1,5,1,1,1,1,0],
    [0,0,0,0,0,0,0,5,0,0,0,0,0,1,0,0,0,0],
    [0,1,1,1,1,1,1,1,1,1,1,1,1,1,1,1,1,0],
    [0,1,1,1,1,1,1,1,1,1,1,1,1,1,1,1,1,0],
    [0,1,1,1,1,1,1,1,1,1,1,1,1,1,1,1,1,0],
    [0,1,1,1,1,1,1,1,1,1,1,1,1,1,1,1,1,0],
    [0,1,1,1,1,1,1,1,1,1,1,1,1,1,1,1,1,0],
    [0,1,1,1,1,1,1,1,1,1,1,1,1,1,1,1,1,0],
    [0,0,0,0,0,0,0,0,0,0,0,0,0,0,0,0,0,0]
  ],
"npcs": [
  {
    "npc_id": "001_001",
    "x": 8,
    "y": 8
  },
  {
    "npc_id": "001_002",
    "x": 3,
    "y": 8
  },
  {
    "npc_id": "001_003",
    "x": 8,
    "y": 10
  }
],
"containers": [],
"hidden_containers": [],
"exits": []
  
}
